1 2 3 4 5 6 7 8 9 0 1 2 3 4 5 6 7 8
0 4 5 2 1 7 8 9 6 5 2 1 4 7 8 5 2 3
4 5 4 1 2 5 4 5 8 9 6 3 2 5 8 8 8 5
1 4 7 8 9 6 5 4 2 0 0 2 1 5 5 8 8 7
3 5 4 5 6 9 8 5 6 5 2 1 4 7 5 6 4 7
1 2 3 4 5 6 7 8 9 0 1 2 3 4 5 6 7 8
0 4 5 2 1 7 8 9 6 5 2 1 4 7 8 5 2 3
4 5 4 1 2 5 4 5 8 9 6 3 2 5 8 8 8 5
1 4 7 8 9 6 5 4 2 0 0 2 1 5 5 8 8 7
3 5 4 5 6 9 8 5 6 5 2 1 4 7 5 6 4 7
1 2 3 4 5 6 7 8 9 0 1 2 3 4 5 6 7 8
0 4 5 2 1 7 8 9 6 5 2 1 4 7 8 5 2 3
4 5 4 1 2 5 4 5 8 9 6 3 2 5 8 8 8 5
1 4 7 8 9 6 5 4 2 0 0 2 1 5 5 8 8 7
3 5 4 5 6 9 8 5 6 5 2 1 4 7 5 6 4 7
4 5 4 1 2 5 4 5 8 9 6 3 2 5 8 8 8 5
1 4 7 8 9 6 5 4 2 0 0 2 1 5 5 8 8 7
3 5 4 5 6 9 8 5 6 5 2 1 4 7 5 6 4 7